type octile
height 7
width 12
map
GhGGGrGGGGSh
GGGGGgGGGGGG
GGGgGGGGGVGG
GGGGGGGHGGGG
GGGGGVGGGGGg
GGGGGGGGGGGG
tGEGGGGGGGGG