type octile
height 7
width 8
map
SGGtGGgr
GGtVhtGG
GHGtGGhG
GGGGhVGG
GGGGGGGG
GtGhhGtG
tGhtGGEG