type octile
height 7
width 8
map
GGGEGGGG
GhtGGhrG
GVGGttGG
GGGGGGVr
GGGHGgGG
GtGhhGGG
rGGGSGGt