type octile
height 7
width 8
map
GGGSGGGG
GhtGGhrG
GVGGttGG
GGGGGGVr
GGGHGgGG
GtGhhGGG
rGGGEGGt